11 10 

1 1 1 1 1 1 1 1 1 1
0 0 0 1 0 0 5 0 0 0
0 1 0 1 0 5 0 1 1 1
0 0 0 0 0 1 0 0 5 3
0 1 1 1 0 1 0 1 1 1 
0 5 0 1 0 1 5 1 0 0
2 1 0 0 0 0 0 0 0 1
0 1 1 1 1 1 1 1 0 0
0 1 0 0 0 0 0 1 1 4
0 1 0 1 0 1 0 0 0 1
1 0 0 0 0 0 0 0 0 1

6