10 10 

0 0 0 0 0 1 0 4 0 1
0 1 1 0 1 1 1 0 0 1
0 1 0 1 0 0 0 0 0 1
0 1 0 1 0 0 1 1 1 1 
0 1 0 4 0 0 0 0 1 0
5 1 0 1 1 1 1 0 1 0
3 1 0 0 0 0 0 0 1 0
6 1 1 1 1 1 0 0 1 0
0 1 0 1 0 1 0 0 0 0
0 0 0 0 0 0 0 0 0 0

6